XXXX XXXXXXXXX XXXXXXXXXX XXXXXXX XXX XXXXXXXXXXX XXXXX
XXXX     XXXXX       XXXX   XXXXX XXX XXXX        XXXXX
XXXX XXXX  XXX XXXXXXXXXX X  XXXX XXX XXX  XXXXXXXXXXXX
XXXX XXXX  XXX XXXXXXXXXX XX  XXX XXX XXX  XXXXXXXXXXXX
XXXX     XXXXX    XXXXXXX XXX  XX XXX XXXX       XXXXXX
XXXX XXXXXXXXX XXXXXXXXXX XXXX  X XXX XXXXXXXXXX  XXXXX
XXXX XXXXXXXXX XXXXXXXXXX XXXXX   XXX XXXXXXXXXX  XXXXX
XXXX XXXXXXXXX       XXXX XXXXXX  XXX XXX        XXXXXX
XXXX XXXXXXXXXXXXXXX XXXXXXXXXXXX XXX XXX XXXXXXXXXXXXX