XXXXXXX XXXXXXXXXXXXXXXX XXXXXXXXXX XXXXXXXXX XX XXXXXXXXXXXX XX XXXXXXXXX XXXXXX
XXXXXXX        XXXXXXXX   XXXXXXXXX   XXXXX   XX        XXXXX XX           XXXXXX
XXXXXXXXXXXXXX XXXXXXX  X  XXXXXXXX X  XXX  X XX XXXXXX  XXXX XXXXXXX XXXXXXXXXXX
XXXXXXXXXXXXXX XXXXXX  XXX  XXXXXXX XX  X  XX XX XXXXXXX  XXX XXXXXXX XXXXXXXXXXX
XXXXXXXXXXXXXX XXXXX  XXXXX  XXXXXX XXX   XXX XX X       XXXX XXXXXXX XXXXXXXXXXX
XXXXXXXXXXXXXX XXXX           XXXXX XXXX XXXX XX XXXXXXX  XXX XXXXXXX XXXXXXXXXXX
XXXXXXX  XXXX  XXX  XXXXXXXXX  XXXX XXXXXXXXX XX XXXXXX  XXXX XXXXXXX XXXXXXXXXXX
XXXXXXXX      XXX  XXXXXXXXXXX  XXX XXXXXXXXX XX        XXXXX XXXXXXX XXXXXXXXXXX
XXXXXXXXXXX XXXXX XXXXXXXXXXXXX XXX XXXXXXXXX XX XXXXXXXXXXXX XXXXXXX XXXXXXXXXXX