XXXXX XXXXX XXXXXXXXXX XXXXXXXXXXXXXXXXXX XXXXXXXX XXXXXXXXXXX XXXXXXXXX XXX XXXXXXXXXX X
XXXXX        XXXXXX                  XXXX XXXXX       XXXXXXXXXXXXXXXXX   X  XXXXXXXX   X
XXXXX          XXXX     XXXXXXXX     XXXX XXX           XXXXXXXXXXXXXXXXX   XXXXXXX     X
XX          XX XXXX     XXXXXXXX     XXXX XXXX         XXXXXXXXXXXXXXXXXX XXXXXXX       X
XX          XX  XXX                  XXXX XXXXXX     XXXXXXXXXXXXXXXXXXX  XXXXX         X
XX          XX  XXXXXXXXXX    XXXXXXXXXXX XXXXXXXX XXXXXXXXXXXXXXXXXXX   XXXX           X
XX          XXX XXXXXXXXXX    XXXXXXXXXXX XXXXXXXX XXXXXXXXXXXXXXX     XXXX             X
XX          XXX XXXXXXXXXX    XXXXXXXXXXX XXXXXXXX XXXXXXXXXXXX    XXXXX                X
XX          XXX XXXXXXXXXX    XXXXXXXXXXX XXXXXXXX XXXXXXX      XXXXX                   X
XX          XXX XXXXXXXXXX          XXXXX XXXXXXXX XXXX    XXXXXXXXX                    X
XX          XXX XXXXXXXXXX    XXXXXXXXXXX XXXXXXXX XXXX XXXXXXXXXXXX                    X
XX          XXX XXXXXXXXXX        XXXXXXX XXXXXXXX XXXX      XXXXXXXXXX                 X
XX          XXX XXXXXXXXXX    XXXXXXXXXXX XXXXXXXX XXXXXXXX      XXXXXXXXXX             X
XX          XXX XXXXXXXXXX          XXXXX XXXXXXXX XXXXXXXXXXXX      XXXXXXXXXX         X
XX          XXX XXXXXXXXXX XXXXXXXXXXXXXX XXXXXXXX XXXXXXXXXXXXXXXXX XXXXXXXXXXXXXXXXXX X
XX          XXX                                                                         X
XXXXXXXXXXXXXXXXXXXXXXXXXXXXXXXXXXXXXXXXX XXXXXXXXXXXXXXXXXXXXXXXXXXXXXXXXXXXXXXXXXXXXXXX